123456789ab
--A-----B--
---C---D---
----H--I---
--G-----G--
-C-------D-