-----A-----
----A------
-----AA----
------A--A-
----A-----A
A----------
-----------
-----------
-----------
-----------
-C-------D-
--C-----D--
---C---D---
----C-D----
----C-D----
--C----D---
C------E-D-
-------E---
-------E---
-------E---
---F---E---
---F---E---
---F----E--
---F------E
---F-------
---F-------
--F--G-----
F----G-----
-----G-----
-----G-----
-----G-----
-----G-----
-----G-----
-----G-----
---H-------
-H--H--I---
--HH--I----
----H--II--
--H---I----
--------I--
-----------
