-----------
-----------
-----------
-----------
------A----
----AAA----
--AAAAA----
AAAAA------
